1-=----2
|      T #
42 1---3       
13 4-_-_-----2   1---2
4--- r__-2   | 0 | # B 
         t   | 1-3   B
        #B#  | 4-2   B
         t   4---3   B
        #4-----___c_-3
            
